@ @ @ @ @ @ @ @ @ @ @ @ @
@ 5 o o o o o o o o o o @
@ o o o o + o o o o x x @
@ o o o o + o o o o x x @
@ o o o o + o o o o o o @
@ o o + + o + o o o o o @
@ o + + + + o o o o o o @
@ o o o o o o o x x x o @
@ o o o o o o o x x x o @
@ o o o o o o o x x x o @
@ @ @ @ @ @ @ @ @ @ @ @ @