@ @ @ @ @ @ @ @ @ @ @ @ @
@ x o o o o o o o o o o @
@ o o o o + o o o o o o @
@ o o o o + o o o o o o @
@ o o o o + o o o o o o @
@ o + + + o + o o o o o @
@ o + + + + o o o o o o @
@ o o o o o o o o o o o @
@ o o o o o o o o o o o @
@ o o o o o o o o o o o @
@ @ @ @ @ @ @ @ @ @ @ @ @